WWWWWWWWWWWWWWWWWWWWWWWWWWWWWWWWWWWWWWWWWWWWWWWWWWWWWWWWWW
W                                                        W
T                                                        T
T                                                        T
T                             WWWWW                      T
T             G               W   W                      T
T             G               W                          T
T             G               WWWWW                      T
T                                                        T
T                                                        T
T                                                        T
W                                                        W
WWWWWWWWWWWWWWWWWWWWWWWWWWWWWWWWWWWWWWWWWWWWWWWWWWWWWWWWWW